###########
#  A      #
#  @   @  #
#  $ o o  #
#         #
#         #
###########