######
#A   ##
# @   #
# # o #
#     #
#######