#########
#   a o #
#  @  @ #
#       #
#   @ o #
#########