#######
#  o  #
# @ # ##
#o#@ @ #
#  o#A #
#   #  #
########